11111111
1E00C0P1
11111111
100C0001
11111111