

11111111
1C0CP001
100000E1
11111111