11111111
1C0CP011
100001E1
11111111