11111111
1C0CE0P1
10000001
11111111