11111111111111
1C00E0P0000001
1000000000CCC1
11111111111111
10000000000001
11111111111111