111111111
10000ECP1
100000010
111111111